###########
#   X  X  #
#  ## ##  #
#  #   #  #
#  Y  Y   #
###########
