###########
#   A  A  #
#  ## ##  #
#  #   #  #
#  B  B   #
###########
