###################
#   A             #
#  #  ## A#       #
#  ##  #  #       #
#  B     B#       #
#                 #
#                 #
###################